%%%%%%%
%%%   %
%. G% %
%P%%% %
% .   %
%%%%%%%
