%%%%%%%%%%%%%%%%%%%%
%.o          ..%   %
%.%%.%%.%%.%%.%% % %
%        P       % %
%%%%%%%%%%%%%%%%%% %
%.....             %
%%%%%%%%%%%%%%%%%%%%
