%%%%%%%
%    P%
% %%% %
%  % o%
%%   %%
%. %%%%
%%%%%%%
